Top N Words::1 - 1000~~~TNW1

the	-T
of	-F
and	SKP
to	TO
a	AEU
in	TPH
that	THA
it	T
is	S
for	TP-R
was	WAS
I	EU
with	W
on	OPB
as	AS
have	SR
but	PWUT
be	-B
they	THE
are	-R
at	AT
by	PWEU
he	E
not	TPHOT
this	TH
we	WE
or	OR
do	TKO
from	TPR
an	APB
so	SO
were	WR
know	TPHOE
like	HRAOEUBG
all	AUL
there	THR
his	HEUS
about	PW
if	TP
has	HAS
what	WHA
just	SKWRUFT
yeah	KWR*E
my	PHEU
had	H
would	WO
more	PHOR
when	WHEPB
can	K
who	WHO
which	WEU
out	OUT
said	SED
their	TRAEUR
no	TPHO
she	SHE
up	UP
been	PW-PB
think	THEU
well	WEL
than	THAPB
some	SOPL
will	HR
because	PWAU
other	OER
did	TK
me	PHE
her	HER
them	THEPL
also	HR-S
people	PAOEPL
time	TAOEUPL
get	TKPWET
right	RAOEUT
these	THEZ
its	EUTS
now	TPHOU
then	THEPB
could	KO
only	OEPBL
really	R-L
into	TPHAO
how	HOU
see	SAOE
most	PHOFT
after	AF
good	TKPWAOD
even	AOEPB
our	OUR
much	PHUFP
here	HAOER
where	W-R
over	OEFR
him	HEUPL
does	TKOS
any	TPHEU
go	TKPW
first	TPEURS
years	KWRAOERS
those	THOZ
way	WAEU
too	TAO
may	PHAE
very	SRE
many	PHAEPB
going	TKPWOG
new	TPHU
should	SHOULD
such	SUFP
used	AOUFD
make	PHAEUBG
got	TKPWOT
work	WORBG
year	KWRAOER
say	SAEU
last	HRAFT
back	PWABG
still	STEUL
between	TWAOEPB
something	S-G
little	HREUL
mean	PHAOEPB
both	PWO*T
each	AOEFP
before	PW-F
lot	HROT
being	-BG
same	SAEUPL
through	THRU
thing	THEUPBG
while	WHAOEUL
want	WAPBT
use	AOUS
things	THEUPBGS
down	TKOUPB
take	TAEUBG
made	PHAED
off	OF
kind	KAOEUPBD
cells	KRELS
never	TPHEFR
since	SEUPBS
data	TKAET
might	PHAOEUT
okay	OBG
day	TKAEU
another	TPHOER
different	TKEUFRPB
using	AOUFG
around	ARPBD
why	KWR
us	US
though	THOE
need	TPHAOED
says	SAEUS
during	TKURG
part	PART
number	TPHUPL
long	HROPBG
come	KOPL
found	TPOUPBD
under	TPH-PB
home	HOEPL
however	HOUF
own	OEPB
percent	PERS
every	EFR
probably	PROBL
always	AULS
few	TPAOU
less	HRES
against	TKPWEPBS
life	HRAOEUF
look	HRAOBG
thought	THAUT
actually	TWAEUL
find	TPAOEUPBD
put	PUT
study	STAO*UD
sure	SHUR
high	HAOEU
information	TPH-FGS
big	PWEUG
least	HRAOEFT
money	PHUPB
point	POEUPBT
world	WORLD
family	TPAEPL
show	SHOE
genes	SKWRAO*EPBS
end	EPBD
figure	TPEUG
today	TOED
yes	KWRE
real	RAEL
government	TKPWOFPLT
without	WOUT
story	STOER
next	TPHEGT
analysis	AEPBLS
pretty	PREUT
state	STAEUT
course	KORS
great	TKPWRAET
place	PHRAEUS
week	WAOEBG
expression	EBGS/PREGS
old	OLD
case	KAEUS
called	KAULD
again	TKPWEPB
system	S-PL
set	SET
went	WEPBT
children	KHEURPB
let	HRET
small	SPHAL
whether	WHR
ever	-FR
maybe	PHAEUB
results	RULTS
cell	KREL
once	WUPBS
must	PHUFT
although	HR*T
anything	TPHEUG
either	AOERT
school	SKAOL
several	SEFRL
days	TKAEUS
guess	TKPWES
gene	SKWRAOEPB
doing	TK*G
am	APL
enough	TPHUF
fact	TPABGT
company	K-P
having	SR-G
public	PHREUBG
second	SEBGD
until	TPH-L
group	TKPWRAOUP
patients	PAEURBZ
far	TKP
important	PORPB
among	PHOPBG
control	KROEL
love	HR-F
name	TPHAEUPL
women	WEUPL
help	HEP
away	W*EU
including	KHRUG
feel	TPAOEL
getting	TKPWEGT
done	TKOPB
give	TKPWEUF
yet	TPHET
man	PHAPB
report	RORP
bad	PWAD
human	HAOUPL
care	KAEUR
example	KP-PL
seems	SAOEPLS
whole	WHOEL
problem	PRO*B
stuff	STUF
seen	SAOEPB
read	RAED
times	TAOEUPLS
early	ERL
within	W-PB
country	KREU
ago	AG
program	PRAPL
came	KAEUPL
often	OFPB
makes	PHAEUBGS
protein	PROEUPB
trying	TRAOEUG
almost	HR-PL
given	TKPWEUFPB
book	PWAOBG
rather	RAER
left	HREFT
business	PWEUS
keep	KAOEP
large	HRARPBLG
true	TRAOU
house	HOUS
call	KAUL
tell	TEL
change	KHAEUPBG
known	TPHOEPB
someone	SPH-PB
site	SAO*EUT
water	WAUR
possible	POB
hard	HARD
already	HR-R
told	TOLD
making	PHAEUG
studies	STAO*UDZ
based	PWAEUFD
able	ABL
major	PHAEUPBLG
similar	SEUPL
else	ELS
night	TPHAOEUT
took	TAOBG
sequence	SKWEPBS
saying	SAEUG
everything	EFRG
city	STEU
play	PHRAEU
shown	SHOEPB
along	AOLG
bit	PWEUT
later	HRAEURT
area	KWRA*ER
sort	SORT
question	KWE
kids	KEUDZ
news	TPHUS
become	PW-BG
line	HRAOEUPB
pay	PAEU
idea	KWR-D
president	PREZ
order	ORD
person	PERPB
type	TAOEUP
past	PAFT
market	PHARBGT
try	TREU
according	KORG
levels	HREFLS
support	SPOR
level	HREFL
together	TOGT
nothing	TPHOG
job	SKWROB
others	OERS
effect	TPEBGT
test	TEFT
believe	PWHREF
paper	PAEUP
run	RUPB
recent	RAOEPBT
car	KAR
likely	HRAOEULG
words	WORDZ
remember	RER
talk	TAUBG
start	START
reported	RORPD
hours	HOURS
significant	SEUG
death	TK*ET
quite	KWAOEUT
sense	SEPBS
power	POUR
side	SAOEUD
means	PHAOEPBS
top	TOP
men	PHEPB
nice	TPHAOEUS
live	HREUF
months	PHO*PBTS
especially	EPS
political	PHREUL
present	PREPBT
cost	KOFT
available	SRAEUBL
half	HAF
working	WOG
age	AEUPBLG
law	HRAU
wanted	WAPBTD
looking	HRAOG
history	HEUFRT
companies	K-PS
single	SEUPBLG
word	WORD
health	H*ELT
federal	TPRAL
total	TOELT
season	S-PB
changes	KHAEUPBGS
sometimes	STAOEUPLS
movie	PHOEF
cases	KAEUSZ
talking	TAUG
local	HROEL
general	SKWREPBL
reason	R-PB
instead	STPHED
issue	*EURB
evidence	AEFD
across	KRAOS
treatment	TRAOEPLT
interesting	TR-G
members	PHEPLS
head	HED
seem	SAOEPL
asked	SK-D
further	TPURT
process	PROEUS
proteins	PROEUPBS
rate	RAEUT
additional	ALG
increase	EUPB/KRAOES
activity	TAEFT
started	STARTD
model	PHOLD
problems	PRO*BS
room	RAOPL
role	ROEL
described	SKREUD
reports	RORPS
thus	THUS
saw	SAU
usually	AOURBL
following	TPOLG
everyone	EFRPB
form	TPORPL
response	SPOPBS
provide	PROEUFD
current	KAOURPBT
groups	TKPWRAOUPS
couple	KUPL
anyone	TPHEUPB
higher	HAOEUR
shows	SHOES
hand	HAPBD
watch	WAFP
comes	KOPLS
goes	TKPW-S
buy	PWAOEU
perhaps	PRAPS
plan	PHRAPB
close	KHROES
risk	REUFBG
office	OFS
act	ABGT
low	HROE
legal	HRAOEL
late	HRAEUT
whose	WHOZ
specific	SPEFBG
deal	TKAOEL
per	PER
recently	RAOEPBLT
former	TPRORPL
town	TOUPB
lead	HRAOED
heard	HERD
free	TPRAOE
taken	TAEPB
taking	TAEUG
minutes	PHEUPBS
black	PWHRABG
above	PWOF
interest	TR
thinking	THEUG
result	RULT
sequences	SKWEPBSZ
value	SRAOUL
wrong	WROPBG
include	KHRU
guy	TKPWAOEU
whatever	WHAFR
involved	SROFD
parents	PAEURPBTS
team	TAOEPL
front	TPOPBT
matter	PHAERT
increased	EUPB/KRAOES/-D
gets	TKPWETS
himself	HEUPLS
growth	TKPWRO*ET
gonna	TKPW*G
national	TPHAT
officials	TPEURBLS
development	SREPLT
lost	HRO*S
month	PHO*PBT
full	TPUL
weeks	WAOEBGS
coming	KOPLG
function	TPUBGS
compared	KPARD
addition	AGS
turn	TURPB
open	OEP
outside	OUDZ
mind	PHAOEUPBD
stock	STOBG
questions	KWES
child	KHAOEULD
programs	PRAPLS
certain	SERPB
war	WAR
average	AFRG
research	REFRPB
itself	*EUTS
effects	TPEBGTS
tax	TABGS
white	WHAOEUT
mother	PHOER
individual	SREUD
music	PHAOUFBG
associated	SOERBTD
knew	TPHAOU
region	RAOEGS
service	S-FS
difference	TKEUFRPBS
woman	WOPL
fun	TPUPB
understand	URPBD
future	TPAOUFP
services	S-FSZ
anyway	TPHAE
issues	*EURBS
clear	KHRAOER
drug	TKRUG
game	TKPWAEUPL
class	KHRAS
final	TPAOEUPBL
gave	TKPWAEUF
common	KPHOPB
food	TPAOD
observed	OEBD
friends	TPREPBDZ
move	PHOF
friend	TPREPBD
air	AEUR
list	HR*EUS
needs	TPHAOEDZ
short	SHORT
financial	TP-PBL
exactly	SA*LGT
cut	KUT
except	KPEPT
behind	HEUPBD
special	SPERBL
hope	HOEP
expected	KP-PTD
required	RAOEURD
potential	PEPBL
blood	PWHRAOD
morning	PHORPBG
needed	TPHAOETD
disease	STKAOES
century	KROEURPBT
identified	AOEUFD/-D
living	HREUFG
particular	PHRAR
interview	EUPBT/SRAOU
showed	SHOED
finally	TPHRAOEUPBL
language	HRAPBLG
performance	PORPBGS
themselves	THEPLS
therefore	TH-FR
due	TKAOU
personal	PERPBL
security	SKAOURT
summer	SURPL
period	PAOERD
terms	TERPLS
military	PHEULT
related	RAELTD
lower	HROER
values	SRAOULS
normal	TPHOL
computer	KPAOURT
added	AD/-D
cancer	SKER
body	PWO*ED
became	PWAEUPL
culture	KURLT
face	TPAEUS
population	PHRAEUGS
stop	STOP
amount	APLT
film	TPEUPL
points	POEUPBTS
standard	ST-D
article	ARL
position	POGS
longer	HRORPBG
students	STAOUPBTS
rule	RAOUL
campaign	KPAEUPB
hear	HAER
considered	K-RD
page	PAEUPBLG
community	KPHAOUPBT
piece	PAOES
private	PRAOEUFT
size	SAOEUZ
performed	P-FRPLD
leave	HREF
main	PHAEUPB
ask	SK
wife	WAOEUF
near	TPHAOER
worked	WORBGD
gone	TKPWOPB
quality	KWALT
costs	KOFTS
binding	PWAOEUPBGD
complex	KPHREBGS
inside	EUPB/SAOEUD
began	TKPWAPB
previously	PRAOEFL
hit	HEUT
approach	A/PROEFP
experience	SPAOERPBS
books	PWAOBGS
section	SEBGS
strong	STROPBG
sex	S-BGS
nearly	TPHAOERL
rest	REFT
soon	SAOPB
heart	HART
action	A*BGS
economic	KPHEUBG
states	STAEUTS
tried	TRAOEUD
sites	SAO*EUTS
policy	POEULS
turned	TURPBD
view	SRAOU
note	TPHOET
takes	TAEUBGS
father	TPAER
works	WORBGS
expressed	EBGS/PREFD
center	STR
building	PWEULGD
subject	SUBT
industry	STREU
included	KHRUD
looked	HRAOBGD
despite	STKPAOEUT
cannot	K/TPHOT
stories	STOERS
agree	TKPWRAOE
various	SRAEURS
toward	TORD
ways	WAEUS
answer	AEPBS
college	KHREPBLG
husband	HUS
wrote	WRO
party	PAERT
myself	PHAO*EUS
lines	HRAOEUPBS
reading	RAEGD
earlier	RERL
seemed	SAOEPLD
cause	KAUZ
difficult	TKEUFLT
cover	KOFR
differences	TKEUFRPBSZ
one	WUPB
areas	KWRA*ERS
everybody	EFRB
happened	HAPD
conditions	K-PBS
moved	PHOFD
decision	STKEUGS
provided	PROEUFD/-D
space	SPAEUS
fall	TPAL
please	PHRES
stay	STAEU
range	RAEUPBG
presence	PREPBS
systems	S-PLS
certainly	SERPBL
alone	A/HROEPB
looks	HRAOBGS
hour	HOUR
attention	TAEPBGS
built	PWEULT
easy	EZ
species	SPAOERBZ
original	ORPBLG
particularly	PHRARL
administration	AD/STRAEUGS
happy	HAEP
bring	PWREU
fine	TPAOEUPB
light	HRAOEUT
design	STKAOEUPB
address	AD/RES
miles	PHAOEULS
guys	TKPWAOEUS
lives	HREUFS
complete	KPHRAOET
rates	RAEUTS
running	RUPB/-G
social	SOERBL
series	SAOERZ
management	PHAPLT
sounds	SOUPBDZ
felt	TPELT
simply	SAO*EPL
wants	WAPBTS
structure	STRUFP
dollars	TKHRARS
greater	TKPWRAERT
consider	K-R
generally	SKWRERPBL
product	PROUBGT
brought	PWRAUT
technology	TEPBLG
character	KRAR
products	PROUBGTS
watching	WAFPG
happen	HAP
factors	TPARBGTS
term	TERPL
somebody	S-B
writing	WREUG
funny	TPAOUPB
director	TKROR
medical	PHED/K-L
independent	TPHAEPBT
papers	PAEUPS
spent	SPEPBT
moment	PHOEPLT
determine	TKERPL
record	RORD
events	AOEFPBTS
played	PHRAEUD
art	ART
mice	PHAOEUS
meeting	PHAOEGT
numbers	TPHUPLS
supposed	SPOED
share	SHAEUR
agency	AGT/SEU
ability	ABT
review	RE/SRAOU
upon	POPB
worth	WO*RT
court	KORT
method	PHO*D
discussion	SKUGS
families	TPAEPLS
determined	TKERPLD
written	WREUPB
price	PRAOEUS
playing	PHRAEUG
previous	PRAOEFS
significantly	SEULG
methods	PHO*DZ
benefits	PWEFPBTS
calls	KAULS
chance	KHAPBS
spend	SPEPBD
economy	KPHEU
nation	TPH-GS
bill	PWEUL
received	SAOEFD
phone	TPOEPB
primary	PRAOEURPL
episode	EP/SOED
production	PRUBGS
completely	KPHRAOELT
popular	PHRA*R
led	HRED
poor	PAOR
son	SOPB
relationship	R*EUP
positive	PEUF
entire	SPWAOEUR
capital	KPAL
file	TPAOEUL
suggest	SUG
version	SRERGS
corporate	KORPT
situation	SEUFP
samples	SA*EPLS
budget	PWUGT
killed	killed
containing	KAUPB/TAEUPBG
drive	TKRAOEUF
education	ED/KAEUGS
factor	TPARBGT
unless	TPH-LS
drugs	TKRUGS
field	TPAOELD
followed	TPOLD
hot	HOT
visit	SREUFT
lack	HRABG
return	RURPB
mostly	PHOEFL
collection	KHREBGS
sound	SOUPBD
cool	KAOL
vote	SROET
indeed	TPHAOEPBD
patient	PAEURBT
beyond	KWROPBD
plans	PHRAPBS
church	KHUFRPB
workers	WORBG/ERS
died	TKAOEUD
police	PHREUS
dead	TKED
sorry	SOER
decided	STKAOEUTD
highly	HAOEUL
favorite	TPAEUFRT
held	HELD
training	TRAEUPBG
access	KPES
staff	STAF
schools	SKAOLS
changed	KHAEUPBGD
executive	SKAOUT/EUF
meet	PHAOET
television	T*FGS
force	TPORS
hold	HOLD
thanks	THA*PBGS
older	OERLD
places	PHRAEUSZ
sample	SA*EPL
huge	HAOUPBLG
background	PW-GD
ok	O*EBG
rules	RAOULS
developed	SRELD
experiments	SPERPLTS
foreign	TPORPB
rights	RAOEUTS
clearly	KHRAOERL
loss	HROS
allowed	HRO*UD
countries	KREU/-S
effective	TPEBGT/TEUF
apparently	PAEURPBLT
key	KAOE
offer	OFR
organization	ORGS
below	PWHRO
directly	TKREBLGT
enjoy	EPB/SKWROEU
check	KHEBG
lived	HREUFD
paid	PAEUD
post	POEFT
named	TPHAEUPLD
source	SORS
remains	RAEUPLS
board	PWAORD
chief	KHAOEF
kept	KEPT
wait	WAEUT
names	TPHAEUPLS
knows	TPHOEZ
tissue	T*EURB
basis	PWAES
continue	T-PB
reaction	RE/-BGS
brain	PWRAEUPB
stage	STAEUPBLG
necessary	TPHES
volume	SROL
account	K-T
hair	HAEUR
mail	PHAEUL
choice	KHOEUS
none	TPHOPB
step	STEP
sent	SEPBT
trial	TRAOEUL
press	PRES
credit	KRETD
multiple	PH-PL
kill	KEUL
bought	PWAUT
write	WREU
agencies	AGT/SEUZ
wonder	WOPBD
starting	STARGT
allow	HRO*U
software	SWA*EUR
suggests	SUGZ
giving	TKPWEUFG
concentration	SKRAEUGS
leads	HRAOEDZ
official	TPEURBL
eat	AOET
designed	STKAOEUPBD
girl	TKPWEURL
beginning	TKPWEUPBG
serious	SAOERS
door	TKAOR
appears	A/PAOERS
race	RAEUS
activities	TAEFTS
nuclear	TPHAOUBG/HRAR
clinical	KHREUPBL
weight	WAET
red	RED
leading	HRAOEGD
practice	PRABGTS
trade	TRAEUD
boy	PWOEU
models	PHO*LDZ
simple	S*EUPL
base	PWAEUS
send	SEPBD
efforts	EFRTS
road	RAOD
overall	AUFRL
movies	PHOEFS
pressure	PRERB
appropriate	PROEPT
spending	SPEPBGD
natural	TPHARL
growing	TKPWROEG
gives	TKPWEUFS
types	TAOEUPS
feeling	TPAOELG
central	STRAL
walk	WAUBG
dear	TKAER
learn	HRERPB
liked	HRAOEUBGD
picture	P*EUFP
income	TPH-BG
limited	HREUPLTD
speech	SPAOEFP
proposed	PROEPD
fight	TPAOEUT
reasons	R-PBS
eyes	AO*EUS
ground	TKPWROUPBD
contrast	KRAEFT
middle	PH*EULD
comment	KPHEPBT
effort	EFRT
relative	REL/TEUF
appear	A/PAOER
initial	TPHEURBL
treated	TRAOETD
modern	PHOERPB
equal	KWAL
created	KRAOETD
consistent	KAOPBT
players	PHRAEURS
pick	PEUBG
comments	KPHEPBTS
measure	PH*ERB
noted	TPHOETD
critics	KREUT/EUBGS
attack	A/TABG
majority	PHAEUPBLGT
met	PHET
employees	PHRAOUS
parts	PARTS
produced	PRO*UD
totally	THROELT
notes	TPHOETS
includes	KHRUS
international	TPHA*EL
actual	TWAUL
fire	TPAOEUR
regions	RAOEGS/-S
scene	SAEPB
direct	TKREBGT
basically	PWHRAEUFBG
evil	AOEFL
yesterday	KWRED
style	STAOEUL
imagine	PHAPBLG
larger	HRAERPBLG
standards	ST-DZ
unit	AOUPBT
animals	PHAPBLS
date	TKAEUT
plus	PHRUS
suggested	SUGD
critical	KR*EUL
nor	TPHOR
break	PWRAEBG
daughter	TKAUR
provides	PROEUFDZ
shot	SHOT